{
    "set": "tanks-tiles.json",
    "cell_size": 1,
    "width": 10,
    "cells": [
        0,0,1,0,0,1,1,1,1,1,
        0,0,0,0,0,0,0,0,0,1,
        1,0,0,0,0,0,0,0,0,1,
        1,0,1,1,1,1,1,0,0,1,
        1,0,1,0,0,0,0,0,0,1,
        0,0,0,0,1,1,1,0,0,0,
        0,0,0,0,0,1,0,0,0,0,
        1,0,1,0,0,1,0,0,0,1,
        1,0,0,0,0,0,0,0,0,1,
        1,1,1,0,0,1,1,1,1,1
    ]
}